[BDCFF]
[game]
Name=Testcave
Author=Testcave
Date=1989
Charset=Original
Fontset=Original
Levels=1
Caves=17

[cave]
Name=Testcave
Intermission=false
CaveDelay=8
CaveTime=99
DiamondsRequired=2
DiamondValue=10 20
AmoebaTime=90
MagicWallTime=10
Colors=Black Black Orange Brown Cyan

[map]
WWWWWWWWWWWWWWW    
W   WWWWWW  . X    
W       aW  . WWWWW
W   WWWWWW  .BW   W
W        .  ..  x W
Wol       P   WWWWW
WWWWWWWWWWWWWWW    
[/map]
[/cave]